upside down - вверх ногами
on top of these - помимо этого
run out - выдыхаться, заканчиваться
tail - хвост
feather - перо
resides - проживать, находиться, пребывать, жить
belong - принадлежать
on occasion - при случае, по случаю
occasionally - иногда, изредка, время от времени
curious - любопытный
destined - предназначенный
destiny - предназначение, судьба, удел, неизбежность
fate - судьба
scar - шрам
to speak - произносить (что-то), говорить
seem - казаться, выглядеть, звучать, мерещиться
to annoy - раздражать
annoyed - раздражённый
plenty - много, большое количество
a courage - смелость
dismal - печально, мрачно, уныло
subtle - точный
predisposition - предрасположение
to bewitch - заколдовать
to ensnare - обмануть, поймать в ловушку
to bottle - разлить по бутылкам
to brew - варить
to put a stopper - закупорить
then again - впрочем
an infusion - настойка
to go out - гулять
pity - жалость, сожаление, печальный факт
clearly - ясно, понятно, ну вот видите
a fame - слава
a greed - жадность
harp string - струна арфы
to turn - поворачивать, вращать, превращаться, становиться
a weak - слабый
actually - на самом деле, в действительности, собственно, фактически
a remembrall - напоминалка
to borrow - отдолжить (у кого-то), брать взаймы
to forgive - прощать
to forgot - забывать
to remember - вспоминать
to broke into - ворваться (куда-то)
believed to - считается, если верить (кому-то)
a number - ряд, число, количество, численность
to acknowledge - признавать
a breach - нарушение
to insist - настаивать
a vault - хранилище
empty - пустой
emptied - опустошённый
odd - странный, нечётный
a hooch - крюк
step up - подойти
to stick - держать, придерживаться, прилипать
once - как только, сразу, единожды
a grip - захват, сцепление, тиски
to grip - обхватить, захватить
a tight - плотный
to kick off - оттолкнуться
hover - зависнуть, парить (над землёй), висеть, зависать
lean - опираться
slightly - слегка, слабо, немного, незначительно
to touch - коснуться, прикоснуться
a touch - прикосновение
instant - немедленно
come back - вернуться
go out of the way - уйти с дороги
a wrist - запястье
a wing - крыло
to expell - изгнать, исключать, высылать, выталкивать, выбрасывать
to squeeze - сжимать, крепко держать
an arse - жопа
bit - немного
beyond the reach - недосягаемый
beyond - за
besides - помимо, кроме
behind - позади
no way - так нельзя, не делай этого
to knock off - сбить, отряхнуть
is that so? - это всё?
have it your way - пусть будет по твоему
nice going - хорошо идёшь
that was wicked - это было ужасно
seeker - ловец
according to - согласно кому-то
make promise - обещать
to vanish - исчезать
go on - да ладно тебе, давай же
make a fool of myself - выставить себя дураком
spooky - жуткий
let's go this way - пойдём этим путём
supposed - предполагаемый, мнимый
we are not supposed to be here - нам нельзя сюда заходить
forbidden - запрещено
more over - более того
locked up - взаперти
preoccupied - озабочен, взволнован
trap door - люк
trap - ловушка
it wasn't there an accident - это было не случайно
to guard - охранять
worse - хуже
to sort out - отсортировать, перебрать, пересмотреть
a hoop - кольцо
nasty - противный, гадкий, наприятный, мерзкий, отвратительный, злобный, опасный
to worry - беспокоиться
retire - выходить на пенсию
an appeal - обращение
to hire - нанимать
determined - решительно настроенный
affection - привязанность
adolescent - юноша
mature - зрелый
somehow - как-то
to rehearse - репетировать, повторять, перечислять, пересказывать
rudimentary - элементарный, начальный
to swish - рассечь воздух, свист, взмах со свистом, шелестеть
to flick - взмахнуть, смахнуть лёгким ударом, смахнуть щелчком
enunciate - произность, отчётливо произносить, ясно произносить
to take eye out - выбить глаз
going to need - понадобится
a dungeon - подземелье
ought to know - должен знать
a dormitory - общежитие
be that as it may - как бы то ни было
foolish - глупо
rational - рациональный, разумный
behavior - поведение
to disappoint - разочаровываться
sheer - чистый, явный, сущий
dumb - глупый, немой, тупой, молчаливый, онемевший
might - мощь, сила, энергия, могущество, может
mate - приятель
against - против
even - даже
limp - хромать
nonsense - ерунда, чепуха, чушь, бессмыслица, абсурд
lent - оддолжать (кому-то)
codswallop - чепуха, бред собачий, тупица
blink - моргать, мигать
to meddle - вмешиваться, ввязываться, соваться не в своё дело
bell - звонок (в который звонят)
ring - звонить
to cast the spell - наложить заклятие, заклинать
barbaric - варварский
totally - полностью, абсолютно
influence - влияние
wear - носить
what are you wearing? - что ты надел?
possession - владение, обладание
a cloak - мантия
a fiend - злодей
mean - значит, значить, иметь ввиду
properly - правильно, как следует, хорошенько, прилично, пристойно, должным образом
delight - восторг, наслаждение, удовольствие, восхищение, очарование
to discover - открыть (узнать впервые)
erised - возбуждённый
trust - доверять
clue - подсказка
deep - глубокий
desperate - безрассудный, отчаянный, безнадёжный
desire - желание, пожелание, страсть, мечта, сильное желание, волеизъявление
beside - рядом
neither - ни один, никто, никакой
wasted away - тратить время впустую, чахнуть, истощаться, умирать, приходить к концу
mad - сумасшедший
to dwell - жить, пребывать, останавливаться
to dwell on dreams - жить в мечтах
a substance - вещество, сущность, материя, имущество
to astonish - удивлять, изумлять
pure - чистый
produce - производить, вырабатывать, создавать
existence - существование, наличие, бытие
rude - грубый
to entertain - развлекать
enchantment - очарование, волшебство, колдовство, магия
to bless - благословить
a bless - благословение
punishment - наказание
to ensure - гарантировать, застраховать, обеспечить
a detention - задержание, удержание, задержка, заключение под стражу, оставление после уроков
honorable - почётный, благородный, честный
an intension - намерение, цель, замысел
a thumb - большой палец
to miss - скучать, пропускать
to serve - обслуживать, подавать, удовлетворять
pull yourself together - взять себя в руки
wits - ум, остроумие
werewolf - оборотень
nighty-night - спокойной ночи
unicorn - единорог
beast - животное
poor - бедный
a bloody coward - чёртов трус
a coward - трус
servant - прислуга, слуга, служащий
especially - особенно
monstrous - ужасный, чудовищный, уродливый, безобразный, отвратительный, жестокий
its - его, её, принадлежащий ей/ему
an inch - дюйм
price - цена
curse - проклятие
at this very moment - в этот самый момент
fear - страх
fright - испуг, страх, страшилище, пугало
wander - блуждать, бродить, скитаться, странствовать, мотаться
hood - капюшон
urgent - срочный, безотлагательный, экстренный
owl - сова
assure - уверять (кого-то), гарантировать, обеспечивать, убеждать
you ought to be careful - вам следует быть осторожным
up to something - что-то задумал
to sneak - красться
brilliant - блестящий, сверкающий, блистательный
scary - страшный
to scare - напугать
a snor - храп
to snor - храпеть
horrible - ужасный, страшный, отвратительный, противный
breath - дыхание
apparently - по всей видимости
fit - соответствовать, устанавливать, подходить, совпадать
worse to try - стоит попробовать
rusty - ржавый
to complicate - усложнять, осложнять
a graveyard - кладбище
a knight - рыцарь, конь, витязь, всадник, донкихот
a castle - замок, дворец, ладья
a pawn - пешка
to sacrifice - пожертвовать
a sacrifice - жертва
cleverness - сообразительность, ловкость, одарённость, умение, искусство
bravery - храбрость, мужество
next to him - рядом с ним
to suspect - подозревать, предполагать, полагать, сомневаться в истинности
to stutter - заикаться, запинаться
countercurse - контрзаклятье
to head - препятствовать
rarely - редко
shake hands - пожать руки
mere - простой, сущий, не более чем, всего лишь
live off another - жить за счёт другого
to sustain - выдерживать, поддерживать, подкреплять, подпирать
convinient - удобный
conviniently - удобно
horrific - ужасный
extraordinary - необыкновенный
a liar - лжец
an admirer - поклонник
token - подарок на память, жетон
complete - полный, законченный, совершённый, абсолютный
naturally - естественно
whole - целый
chat - беседа, болтовня, дружеский разговор
how is it - как это?
to bear - выносить, терпеть, выдержать
alas - увы
never better - лучше не бывает
grave peril - серьёзная опасность
composure - хладнокровие, самообладание, спокойствие
outstanding - выдающийся
tied - привязанный, связанный
assuming - предполагая
dolt - болван, раздолбай, дурень
a grief - горе, печаль, огорчение, беда
to threat - угрожать
to offend - оскроблять, обижать, задевать
alongside - около, рядом, у
outside - вне, за пределами, за исключением
within - внутри, в пределах, не далее
wherewith - чем, посредством которого
for the sake of - ради
above - выше, над
across from - напротив, через дорогу от
around - вокруг
below - ниже, под
between - между
in front of - впереди, перед
opposite - напротив
over - над
past - за, по ту сторону
to give up - сдаваться, прекращать
to find out - выяснить, узнать
to take off - взлететь, быстро уйти
to go on - продолжать
to look after - заботиться, присматривать
to come across - наткнуться, случайно найти, встретить, повстречаться, натолкнуться, набрести
to put up with - терпеть, мириться с чем-либо
to come up with - придумывать
to look up to - уважать, брать пример
to walk out - выйти
to ride out - выехать
to cry out - выкрикнуть
to call out - призвать, воззвать
to pass out - раздать, отключиться, потерять сознание
to parcel out - разослать
to take after - брать пример, походить на кого-либо
to predict - предсказать
to blow up - взрывать, взрываться
to explode - взрывать
to pull out - извлекать, вытаскивать
to extract - извлекать, вытаскивать
to put out - гасить
to speed up - ускоряться
to accelerate - ускоряться
to point out - показывать
to indicate - показывать
to leave out - упускать
to omit - упускать
to find out - уточнять, выяснять
to ascertain - уточнять, выяснять
to put together - собирать
to assemble - собирать
to compose - собирать
to spot - определить
a pile - куча, груда, свая, кипа, пачка
to disturb - беспокоить, мешать, нарушать, волновать, смущать
a scuba - акваланг
freaky - причудливый, капризный
purely - исключительно
to pretend - притворяться
decent - приличный, порядочный, пристойный, славный
ill - плохо, дурно, худо
to warn - предупредить
a plot - сюжет, заговор, план, интрига
nephew - племянник
to upset - расстраивать, огорчать
upstairs - наверху
a trunk - багажник, чемодан 
to blame - винить
to starve - голодать, морить голодом
tuck in - засунуть, подгибать, есть с жадностью, давиться
facinating - увлекательный, очаровательный, пленительный, обворожительный
good lord - о боже
to enchant - очаровывать, околдовывать
indeed - на самом деле, впрямь, уж, действительно
a rubber duck - резиновая утка
cheap - дёшево
diagon - косой(ая)
a powder - порох, порошок
aware - осведомлённый, знающий
to conduct - производить
to prove - доказывать, подтверждать
embarracing - смущающий, затруднительный
to skulk - красться, скрываться
dodgy - гиблый
hang on - постой
free of charge - бесплатно
disgrace - позор, немилость, бесчестие
lads - ребята, братва
an exposure - контакт, разоблачение, обличение
a mention - упоминание
to inflict - наносить
to rest - пренебрегать, насмехаться, глумиться, презирать
bylaws - устав
custard - заварной крем
tart - пирог
anxious - тревожный, озабоченный, беспокойный, волнующийся
petrified - окаменеть, остолбенеть, превращаться в камень, ошеломлять
statement - заявление
faint - слабый, тусклый, обморочный, робкий
doom - гибель, приговор, смерть
a menace - наказание, опасность, чистое наказание
to dare - дерзать, сметь, рисковать, посметь
an inquiry - запрос, спрос, дознание, расследование
entirely - полностью
fault - вина
to rid - освобождать, избавлять
harm - вред
befall - падать, приключаться, происходить, случаться
whilst - в то время как, тогда как, покуда
devilishly - дьявольски, чертовски
tricky - хитрый, ловкий, каверзный, сложный, запутанный
a blighter - мерзавец
to devise - придумывать, разрабатывать, изобретать
to book - бронировать
to smell - нюхать, чувствовать запах
hereby - настоящим, таким образом, этим
owing - обязанный, должный, причитающийся
unlike some - в отличии от некоторых
to afford - позволить себе, предоставлять, давать, приносить, быть в состоянии сделать
filthy - грязный, мерзкий, отвратительный
anyway - тем не менее, во всяком случае, так или иначе
fickle - непостоянный, ненадёжный, переменчивый
drowsy - сонный, сонливый, вялый, дремлющий
to proceed - проследовать, продолжить
a rubbish - мусор, хлам, чушь, вздор
probably - возможно
to appreciate - ценить
to infuriate - бесить, приводить в ярость
mature - зрелый, спелый, развитый
a potion - зелье
to revive - возрождать, восстанавливать, оживлять
caution - осторожность
to admit - признавать
to sway - колебать, качать, поколебать
to seal - запечатывать, герметизировать, опечатывать, запечатать, опечатать, скрепить, уплотнить
a heir - наследник
to unleash - выпустить, высвобождать, высвободить
a scum - накипь, отбросы, пенка
clear off - исчезнуть
to strangle - душить, задушить, удавить, задыхаться, придушить, удушить, удушать, передушить
a vermin - паразит, вредитель, сброд
to enslave - порабощать
moping - мрачный
bloody hell - ну и дичь
attitude - отношение
a hush - тишина, молчание
to hush - замять, замалчивать, умолчать
to polish - полировать, отполировать, отшлифовать, начистить
capable - способный, дееспособный, работоспособный
flee - бежать, убегать, избегать, побежать, убежать, сбежать, разбежаться, уйти, спасаться бегством, разбегаться, бегать, удирать, сбегать
to snatch - похищать
most unfortunate - весьма прискорбно
a fraud - мошенник
dreadful - ужасный
persuasive - убедительный
a capture - разоблачение
a defeat - поражение
sorcerer - волшебник, чародей, колдун
silly - глупый, дурацкий, придурковатый, нелепый, глупенький, глуповатый, тупой, бессмысленный
tears - слёзы
dozen - дюжина
nothing but that - ничего кроме этого
intensionally - ненамеренно
detemination - решительность
resourcefulness - находчивость
certain - определенный, отдельный, конкретный
ridiculous - нелепый, смехотворный, дурацкий, абсурдный, несуразный
curiously - любопытно
dare - осмеливаться, сметь, рисковать, осмелиться, посметь, отважиться, рискнуть, дерзать, дерзнуть
welfare - благосостояние
a culprit - преступник, виновник
to presume - предполагать, полагать, предположить, считать, подразумевать
severe - суровый
recent - недавний
obviously - очевидно
obvious - очевидный
shore - берег
to sink - затонуть
leather - кожа
skin - кожа
derma - кожа
due - должное, причитающийся, обусловленный, должный, надлежащий, соответствующий
brinks - грани
brink - край
eventually - в итоге, в конечном счёте
couple - пара
exposure - экспозиция, контакт
duty - долг, обязанность, пошлина
coast - побережье
excess - избыток, превышение, излишек
distress - бедствие, горе, страдание, несчастье
flood - наводнение, поток, прилив, потоп, паводок
deck - палуба, колода, настил, пол в вагоне трамвая
a sailor - матрос
abandoned - заброшенный
to abandon - покидать
to abondone - отказаться
increasingly - всё больше и больше
issued - выпущен
riotous - буйный, разгульный, шумливый, мятежный
to swamp - заваливать, заливать, затоплять
to go down - спускаться, снижаться, падать, сходить, затонуть, опускаться
a tuxedo - смокинг
to disappear - исчезать
to swarm - роиться, копошиться, лезть
attempt - попытка
scrape - царапать, скрезти, наскребать
distinctly - отчётливо, чётко, внятно
a plunge - погружение, ныряние
to plunge - погружаться, окунаться
approximately - примерно
beneath - под
breaking apart - разваливается
imploading - загрузка, погружение